################################
#S....#....#....~......#......#
#.###..##.#.####.####.#.####..#
#....#....#....#....#.#....#..#
####.#.########.#..#...##.#.###
#....#....~~.......#.#....#...#
#.########.########...######..#
#......~~..#....#...#.#....#..#
#.########.#.##.#.###.#.##.#.##
#.#....#..~#.#..#...#.#..#.#..#
#.#.##.#.###.#.###.#.####.#.###
#...##.#.....#...#.#......#...#
###.##.#########.#.#########.##
#...#.....~~....#.......~~...E#
#.###.#########.#############.#
################################
