################################
#S.....#.......#...............#
#.###..#.#####.#.#######.#####.#
#...#..#.....#.#.....~~..#...#.#
###.#..#####.#.#######.###.#.#.#
#...#........#.....~~..#...#.#.#
#.#########.#######.#####.#.#.##
#.....~~....#.....#.....#.#.#..#
#####.#####.#.###.#####.#.#.##.#
#...#.....#.#.#.#.....#.#...#..#
#.#.#####.#.#.#.#####.#.#####.##
#.#.....#.#.#.#.....#.#.....#..#
#.#####.#.#.#.#####.#.#####.#.##
#.....#.#.#.#.....#.#.....#.#..#
###.#.#.#.#.#####.#.#####.#.##.#
#...#...#.#.....#.#.....#.#..E##
################################
